0 0 0 0 0 0 0 0 0 0 0 0 0 0 0 0 0 0 0 0 
0 0 0 0 0 0 0 0 0 0 0 0 0 0 0 0 1 0 0 0 
0 0 0 0 c c 0 0 1 1 c c 0 0 0 c c c 0 0 
0 0 0 0 c c 2 1 1 c c c 2 1 c c c c c c 
0 0 0 2 c c c 1 c c c c c 1 c c c c c c 
0 0 0 0 b b b b b b b b b b b b b b b b 
0 2 0 0 b b b b b b b b b b b b b b b b 
0 0 0 0 b b b b b b b b b b b b b b b b 
0 0 1 0 a a a a a a a a a a a a a a a a 
0 0 0 1 a a a a a a a a a a a a a a a a 
0 0 0 2 a a a a a a a a a a a a a a a a 
0 0 0 1 b b b b b b b b b b b b b b b b 
0 0 0 2 b b b b b b b b b b b b b b b b 
0 0 0 0 c c 1 2 c c c c c c c c c c c c 
0 0 0 0 c 2 2 1 c c c 2 c c c c c 0 0 c 
0 0 0 1 0 1 0 0 0 c c 0 0 0 c c 0 0 0 c 
0 0 0 0 0 0 0 0 0 0 0 0 0 0 0 0 0 0 0 0 
0 0 0 0 0 0 0 0 0 0 0 0 0 0 0 0 0 0 0 0 
0 0 0 0 0 0 0 0 0 0 0 0 0 0 0 0 0 0 0 0 
0 0 0 0 0 0 0 0 0 0 0 0 0 0 0 0 0 0 0 0 
