0 0 0 0 0 0 0 0 0 1 a a a a a a a 1 0 0 0 0 0 0 0 0
0 0 0 0 0 0 0 1 a a a a a a a a a a 1 0 0 0 0 0 0 0
0 0 0 0 0 0 0 0 1 a a a a a a a a a 1 0 0 0 0 0 0 0
0 0 0 0 0 0 0 0 1 1 a a a a a a a 1 0 0 0 0 0 0 0 0
0 0 0 0 0 0 0 1 a a a a a a a a a 1 0 0 0 0 0 0 0 0
0 0 0 0 0 0 0 0 1 a a a a a a a a 1 0 0 0 0 0 0 0 0
0 0 0 0 0 0 1 a a a a a a a a a 1 a 1 0 0 0 0 0 0 0
0 0 0 0 0 0 0 1 a a a a a a a a a a 1 0 0 0 0 0 0 0
0 0 0 0 0 0 0 1 a a a a a a a a a a 1 0 0 0 0 0 0 0
0 0 0 0 0 0 1 a a a a a a a a a a 1 1 0 0 0 0 0 0 0
0 0 0 0 0 1 a a a a a a a a a a a a a 1 0 0 0 0 0 0
0 0 0 0 0 1 a a a a a a a a a a a a 1 1 0 0 0 0 0 0
0 0 0 0 0 0 1 a a a a a a a a a a a 1 0 0 0 0 0 0 0
0 0 0 0 0 0 0 1 a a a a a a a a a a a a 1 0 0 0 0 0
0 0 0 0 0 0 1 a a a a a a a a a a a a a 1 0 0 0 0 0
0 0 0 0 0 0 0 1 a a a a a a a a a a a 1 0 0 0 0 0 0
0 0 0 0 0 0 a a a a a a a a a a a a a 1 0 0 0 0 0 0
0 0 0 0 0 0 1 a a a a a a a a a a a 1 0 0 0 0 0 0 0
0 0 0 0 0 0 1 a a a a a a a a a a a a 1 0 0 0 0 0 0
0 0 0 0 0 0 0 1 a a a a a a a a a a a 1 0 0 0 0 0 0
0 0 0 0 0 0 0 0 1 a a a a a a a a 1 1 0 0 0 0 0 0 0
0 0 0 0 0 0 0 0 a a a a a a a a a a 1 0 0 0 0 0 0 0
0 0 0 0 0 0 0 0 1 a a a a a a a a 1 0 0 0 0 0 0 0 0
0 0 0 0 0 0 0 1 a a a a a a a a a 1 0 0 0 0 0 0 0 0
0 0 0 0 0 0 0 1 a a a a a a a a a 1 0 0 0 0 0 0 0 0
0 0 0 0 0 0 0 0 1 a a a a a a a 1 0 0 0 0 0 0 0 0 0