0 0 0 0 0 0 0 0 2 a a a a a a a a 2 0 0 0 0 0 0 0 0
0 0 0 0 0 0 0 0 a a a a a a a a a 2 0 0 0 0 0 0 0 0
0 0 0 0 0 0 0 0 2 a a a a a a a a 2 0 0 0 0 0 0 0 0
0 0 0 0 0 0 0 0 2 a a a a a a a a a 0 0 0 0 0 0 0 0
0 0 0 0 0 0 0 2 2 a a a a a a a a a 0 0 0 0 0 0 0 0
0 0 0 0 0 0 2 a a a a a a a a a 2 0 0 0 0 0 0 0 0 0
0 0 0 0 0 2 a a a a a a a a a a a 2 0 0 0 0 0 0 0 0
0 0 0 0 0 0 2 2 a a a a a a a a a a 0 0 0 0 0 0 0 0
0 0 0 0 0 2 a a a a a a a a a a a 2 0 0 0 0 0 0 0 0
0 0 0 0 0 0 2 2 a a a a a a a a a 2 a 0 0 0 0 0 0 0
0 0 0 0 0 0 0 2 a a a a a a a a a a a 2 0 0 0 0 0 0
0 0 0 0 0 0 2 a a a a a a a a a a a a 2 0 0 0 0 0 0
0 0 0 0 0 0 2 a a a a a a a a a a a a 2 0 0 0 0 0 0
0 0 0 0 0 0 a a a a a a a a a a a a a 2 0 0 0 0 0 0
0 0 0 0 0 0 a a a a a a a a a a a a 2 0 0 0 0 0 0 0
0 0 0 0 0 0 a a a a a a a a a a a 2 2 0 0 0 0 0 0 0
0 0 0 0 0 0 2 a a a a a a a a a a a 2 0 0 0 0 0 0 0
0 0 0 0 0 0 a a a a a a a a a a a a a 2 0 0 0 0 0 0
0 0 0 0 0 0 2 a 2 a a a a a a a a a a a 0 0 0 0 0 0
0 0 0 0 0 0 0 0 2 a a a a a a a a a a 2 0 0 a 0 0 0
0 0 0 0 0 0 0 0 2 a a a a a a a a 2 0 0 0 0 0 0 0 0
0 0 0 0 0 0 0 0 0 2 a a a a a a 2 0 0 0 0 0 0 0 0 0
0 0 0 0 0 0 0 0 2 a a a a a a a a 2 0 0 0 0 0 0 0 0
0 0 0 0 0 0 0 0 2 a a a a a a a a 2 0 0 0 0 0 0 0 0
0 0 0 0 0 0 0 0 a a a a a a a a a a 0 0 0 0 0 0 0 0
0 0 0 0 0 0 0 0 2 a a a a a a a a 2 0 0 0 0 0 0 0 0