0 0 0 0 0 0 0 0 0 0 0 0 0 0 0 0 0 0 0 0 0 0 0 0 0 0 
0 0 0 0 0 0 0 0 0 0 0 0 0 0 0 0 0 0 0 0 0 0 0 0 0 0 
0 0 0 0 0 0 0 0 0 0 0 0 0 0 0 0 0 0 0 0 0 0 0 0 0 0 
0 0 0 0 0 0 0 0 0 0 0 0 0 0 0 0 0 0 0 0 0 0 0 0 0 0
0 0 0 0 0 0 0 0 0 0 0 0 0 0 0 1 1 0 0 0 0 0 1 1 1 1
0 0 0 1 1 1 1 0 0 1 1 1 1 0 1 1 1 1 1 1 1 1 1 a a 1
1 1 0 1 a a 1 1 1 1 a a 1 1 1 a a a 1 1 1 1 a a 1 1
1 1 1 1 a a 1 1 1 a a a 1 1 a a a a a 1 a a a a 1 1
1 1 1 a a a a a 1 a a a a 1 a a a a a a a a a a 1 1
1 1 a a a a a a a a a a a a a a a a a a a a a a 1 1
1 1 a a a a a a a a a a a a a a a a a a a a a a 1 1
a a a a a a a a a a a a a a a a a a a a a a a a a a
a a a a a a a a a a a a a a a a a a a a a a a a a a
a a a a a a a a a a a a a a a a a a a a a a a a a a
1 1 a a a a a a a a a c a a a a a a a a a a a a 1 1
1 1 a a a a a a a a a a a a a a a a a a a a a a 1 1
1 1 a a a a a a a a a a a a a a a a a a a a a a 1 1
1 1 a a a a 0 0 a a a a a a a a a a a a a a a a 1 1
0 0 a a a 0 0 0 a a a 0 a a a a a 0 0 a a a a a 1 1
0 0 a a 0 0 0 0 0 a a 0 0 0 a a 0 0 0 a a a a a a 1
0 0 0 0 0 0 0 0 0 0 0 0 0 0 0 0 0 0 0 0 0 0 0 0 0 0
0 0 0 0 0 0 0 0 0 0 0 0 0 0 0 0 0 0 0 0 0 0 0 0 0 0
0 0 0 0 0 0 0 0 0 0 0 0 0 0 0 0 0 0 0 0 0 0 0 0 0 0         
0 0 0 0 0 0 0 0 0 0 0 0 0 0 0 0 0 0 0 0 0 0 0 0 0 0 
0 0 0 0 0 0 0 0 0 0 0 0 0 0 0 0 0 0 0 0 0 0 0 0 0 0 
0 0 0 0 0 0 0 0 0 0 0 0 0 0 0 0 0 0 0 0 0 0 0 0 0 0 
