0 0 0 0 0 0 0 0 1 a a a a a a a a 1 0 0 0 0 0 0 0 0
0 0 0 0 0 0 0 0 0 1 a a a a a a a a 1 0 0 0 0 0 0 0
0 0 0 0 0 0 0 0 1 a a a a a a a a 1 0 0 0 0 0 0 0 0
0 0 0 0 0 0 0 0 a a a a a a a a a 1 0 0 0 0 0 0 0 0
0 0 0 0 0 0 0 1 1 a a a a a a a a a a a 1 0 0 0 0 0
0 0 0 0 0 0 1 1 1 a a a a a a a a 1 a a 1 0 0 0 0 0
0 0 0 0 0 0 1 a a a a a a a a a a a a 1 0 0 0 0 0 0
1 1 1 1 1 1 1 a a a a a a a a a a 1 1 0 0 0 0 0 0 0
1 1 1 a a 1 a a a a a a a a a a a a 1 0 0 0 0 0 0 0
a 1 a a a a a a a a a a a a a a a 1 0 0 0 0 0 0 0 0
a a a a a a a a a a a a a a a a a a 1 0 0 0 0 0 0 0
a a a a a a a a a a a a a a a a a a a 1 0 0 0 0 0 0
a a a a a a a a a a a a a a a a a a a a 1 0 0 0 0 0
a a a a a a a a a a a a a a a a a a a a 1 0 0 0 0 0
a a a a a a a a a a a a a a a a a a 1 1 0 0 0 0 0 0
a a a a a a a a a a a a a a a a a a a 1 0 0 0 0 0 0
a a a a a a a a a a a a a a a a a a a a 0 0 0 0 0 0
a a a a a a a a a 2 2 a a a a a a a a 1 0 0 0 0 0 0
2 a 2 a a a a a 2 2 2 a a a 2 a a a a 1 0 0 0 0 0 0
0 2 0 2 2 a a 2 2 0 0 2 a a 2 2 2 a a 1 0 0 0 0 0 0
0 0 0 0 0 2 2 0 0 0 0 0 2 2 0 0 0 2 2 0 0 0 0 0 0 0
0 0 0 0 0 0 0 0 0 0 0 0 0 0 0 0 0 0 0 0 0 0 0 0 0 0
0 0 0 0 0 0 0 0 0 0 0 0 0 0 0 0 0 0 0 0 0 0 0 0 0 0
0 0 0 0 0 0 0 0 0 0 0 0 0 0 0 0 0 0 0 0 0 0 0 0 0 0
0 0 0 0 0 0 0 0 0 0 0 0 0 0 0 0 0 0 0 0 0 0 0 0 0 0
0 0 0 0 0 0 0 0 0 0 0 0 0 0 0 0 0 0 0 0 0 0 0 0 0 0